22222222222222222222
21111111111111111112
21000000000000000012
21000000000000000012
21000000000000000012
21000000000000000012
21000000000000000012
21000000000000000012
21000000000000000012
21000000000000000012
21000000000000000012
21000000000000000012
21000000000000000012
21000000000000000012
21000000000000000012
21000000000000000012
21000000000000000012
21000000000000000012
21111111111111111112
22222222222222222222